BBBBBBBBBBBBBBBB
BWWW..WWWW..WWWB
BWWW..WWWW..WWWB
B..............B
B....WWWWWW....B
B....WWWWWW....B
BWWW.WWWWWW.WWWB
BWWW.WWWWWW.WWWB
BWWW.WWWWWW.WWWB
BWWW.WWWWWW.WWWB
B....WWWWWW....B
B....WWWWWW....B
B..............B
BWWW..WWWW..WWWB
BWWW..WWWW..WWWB
BBBBBBBBBBBBBBBB
